20 20
------*-------------
----------**--------
***-----------------
-----*--------------
-----------**-------
----*--------------*
------*--------*----
--*--------------*--
--------**----------
----*-----------*---
-------*-----*------
---*--*----*--------
----------------**--
---------***--------
---------*-*--------
---------***--------
*-*-----------------
*-*------------*----
*--*----------------
***-*--*------------