10 10
--*---*---
*--------*
---*-*----
-*---*-*--
----------
-*-----*--
---*---*--
-*--*--*--
-----***--
--*-----**